5分で分かる音羽ララの『歌ってみた』	音羽ララ
【歌編】初心者でも4分で分かる天神子兎音(てんじんことね)	天神子兎音
【歌ってみた作業用bgm】生放送ダイジェスト	天神子兎音
【歌ってみた】サイレントマジョリティ ー / 欅坂46【天神子兎音cover】	天神子兎音	サイレントマジョリティー
【せやな】何でも言うことを聞いてくれるロキチャン【歌ってみた】	ルキロキ	何でも言うことを聞いてくれるアカネチャン
花譜 #03	花譜
花譜 #02	花譜
花譜 #01	花譜
花譜 #16 「活花」-復帰&”雛鳥”予告編- 【オリジナルmv】	花譜
奏でろ音楽!!!full ver.【樋口楓オリジナル曲】	樋口楓	奏でろ音楽!!!
【歌って踊ってみた】チカっとチカ千花っ♡covered by 響木アオ【かぐや様は告らせたい】	響木アオ	チカっとチカ千花っ♡
ミュージックミュージックとあ feat. 初音ミク(covered by 花鋏キョウ)【歌ってみた】	花鋏キョウ	ミュージックミュージック
【女性が歌う】じん−アディショナルメモリー/ jin−additional memory(covered by 花鋏キョウ)【歌ってみた】	花鋏キョウ	アディショナルメモリー
レペゼンvtuberラッパーロボ子!【世界クーリッシュ選手権2018】	ロボ子さん
【ロボ子さん】secret base〜君がくれたもの〜【vtuberコンピレーションアルバム「imagination vol.1」】	ロボ子さん	secret base ~君がくれたもの~
【歌ってみた】チェチェ・チェック・ワンツー / vo.獅子神レオナ【vtuber】	獅子神レオナ	チェチェ・チェック・ワンツー!
【初投稿】【歌ってみた】チェチェ・チェックワンツー!【結城リノ】	結城リノ	チェチェ・チェック・ワンツー!
【cover】クリスマスソングメドレーを歌ってみたよ!2018【富士葵】	富士葵
口だけでカントリーロード歌ってみた / 耳をすませば主題歌/country roads【富士葵】	富士葵	カントリーロード
【歌ってみた】クソダサムーブでエイリアンエイリアン【富士葵】	富士葵	エイリアンエイリアン
【cover】secret base~君がくれたもの~/zone『あの日見た花の名前を僕達はまだ知らない』【ライブ音源】	富士葵	secret base ~君がくれたもの~
【富士葵】新衣装お披露目!!!	富士葵
【cover】セーラームーンメドレー『美少女戦士セーラームーン』sailor moon medley『sailor moon』	富士葵
【応援】葵の感謝の気持ちを伝えます。cover:ファイト!/中島みゆき【富士葵】	富士葵	ファイト!
【cover】クリスマスソングメドレーを歌ってみたよ!【富士葵】	富士葵
【アカペラ】twitterお歌まとめ+α【町田ちま】	町田ちま
えるかざガクのヘンテコディナー	える
歌ってみた【ミウカバーまとめpart1】作業用bgm	ヒヅキミウ
hello,morning/綺羅星ウタver.【歌ってみた】	綺羅星ウタ	hello, morning
【天声に】君の知らない物語supercell cover 【liveで歌ってみた】	双理マイ	君の知らない物語
【天声に】奏−スキマスイッチ−cover.双理マイ~一週間フレンズ主題歌~【歌ってみた】	双理マイ	奏
ゴリラ×ちくわオンステージ「mrs pumpkinの滑稽な夢/ハチ」	ちくわ	mrs.pumpkinの滑稽な夢
完全感覚ドリーマー - one ok rock(cover) / 星乃めあ【歌ってみた】※tbs系テレビ「あらびき団」 2・3月度エンディングテーマ	星乃めあ	完全感覚dreamer
【歌ってみた】2018年総まとめ~デビューからの道のり~【vsinger - 星乃めあ - 】	星乃めあ
【自己紹介】はじめまして♪星乃めあです٩( 'ω' )و【バーチャル歌姫】	星乃めあ
♡メランコリック eurobeat.ver♡/カグラナナ	かぐらなな	メランコリック
snow halationをサビだけ歌ってみた【朝ノ光】	朝ノ姉妹	snow halation
🔴【朝ノ瑠璃】はじめての生放送【生歌配信】	朝ノ姉妹
happy birthday!!キズナアイさん!【朝ノ光、朝ノ瑠璃】	朝ノ姉妹	happy birthday
🔴【朝ノ瑠璃】お姉ちゃんと生電話しませんか?【凸待ち生放送】	朝ノ姉妹
🔴【朝ノ瑠璃】いっぱい動きます💙💙💙 【ゲリラ生放送】	朝ノ姉妹
🔴【朝ノ瑠璃】100曲チャレンジ前夜祭 【雑談配信】	朝ノ姉妹
🔴【朝ノ瑠璃】100曲チャレンジ~夏!・奈々様縛り・acid black cherry縛り編~	朝ノ姉妹
🔴【朝ノ瑠璃】100曲チャレンジ~世代編~	朝ノ姉妹
🔴【朝ノ瑠璃】100曲チャレンジ~bleach&銀魂縛り~【生歌放送】	朝ノ姉妹
【朝ノ瑠璃】100曲チャレンジ振り返り生放送【歌のみ抜粋】	朝ノ姉妹
【2019年も】happy song cover by 朝ノ瑠璃【皆に幸あれ!】	朝ノ姉妹
【ときのそら×アズマリム】2人でmagnet【歌ってみた】	ときのそら	magnet
ときのそら デビューアルバム「dreaming!」 trailer	ときのそら
【歌ってみた】サイレントマジョリティ ー / 欅坂46【花鋏キョウcover】	花鋏キョウ	サイレントマジョリティー
♡future base歌ってみた♡	物述有栖	future base
